6 8
2 2 3 3 2 6 6 3
3 5 3 2 3 6 2 6
4 2 4 3 3 6 6 6
5 4 2 4 4 5 6 6
6 3 3 5 3 2 5 5
2 3 6 5 3 2 6 6
